1111111111111111111111111111
1P000000C000000C00000C0000C1
1011110101111010111110111101
1000010100001010000110000101
1C01110000111000011100011101
1011110101111010111110111101
1000010100001010000110000101
1C01110000111000011100011101
1011110101111010111110111101
1000010100001010000110000101
1C01110000111000011100011101
1011110101111010111110111101
1000010100001010000110000101
1C01110000111000011100011101
10000000000000000000000000E1
1111111111111111111111111111
