1111111111
1P000000C1
1011110101
1000010101
1C01110001
10000000E1
1111111111
