111111111
1P0000C01
101110101
1C00000E1
111111111
