11111111111111111111111111111111111111111111111111111111111111111111111111111111111111111111111111111
1P00000C000000C000000C000000C000000C000000C000000C000000C000000C000000C000000C000000C000000C000000C01
10111101001110100111010011101001110100111010011101001110100111010011101001110100111010011101001110101
1EC0000000C000000C000000C000000C000000C000000C000000C000000C000000C000000C000000C000000C000000C000001
11111111111111111111111111111111111111111111111111111111111111111111111111111111111111111111111111111
