11111111111111111111111111111111111111111111111111111111111111111111111111111111111111111111111111111111111111111111111111111111111111111111111111111111111111111111111111111111111111111111111111111111111111111111111111111111111111111111111111111111111111111111111111111111111111111111111111111111111111111111111111111111111111111111111111111111111111111111111111111111111111111111111111111111111111111111111111111111111111
1R0000C000000C000000C000000C000000C000000C000000C000000C000000C000000C000000C000000C000000C000000C000000C000000C000000C000000C000000C000000C000000C000000C000000C000000C000000C000000C000000C000000C000000C000000C000000C000000C000000C000000C000000C000000C000000C000000C000000C000000C000000C000000C000000C000000C000000C000000C000000C000000C000000C000000C000000C000000C000000C000000C000000C000000C000000C000000C000000C000000C01
10111010011101001110100111010011101001110100111010011101001110100111010011101001110100111010011101001110100111010011101001110100111010011101001110100111010011101001110100111010011101001110100111010011101001110100111010011101001110100111010011101001110100111010011101001110100111010011101001110100111010011101001110100111010011101001110100111010011101001110100111010011101001110100111010011101001110100111010011101001110101
10C000000C000000C000000C000000C000000C000000C000000C000000C000000C000000C000000C000000C000000C000000C000000C000000C000000C000000C000000C000000C000000C000000C000000C000000C000000C000000C000000C000000C000000C000000C000000C000000C000000C000000C000000C000000C000000C000000C000000C000000C000000C000000C000000C000000C000000C000000C000000C000000C000000C000000C000000C000000C000000C000000C000000C000000C000000C000000C000000C000001
11111111111111111111111111111111111111111111111111111111111111111111111111111111111111111111111111111111111111111111111111111111111111111111111111111111111111111111111111111111111111111111111111111111111111111111111111111111111111111111111111111111111111111111111111111111111111111111111111111111111111111111111111111111111111111111111111111111111111111111111111111111111111111111111111111111111111111111111111111111111111
