11111
1P1C1
10101
1E001
11111
