11111
1P0C1
11111
1E111
11111
